1111111111111111111111111333111111111111
1000000000000000000000000000000000000001
1000000000000000000000000000000000000001
1000000111110000000000000000000000000001
1100000000000000000003333000000000000001
1000000000222222222000000000000000000001
1000000000000000000000000000000000000001
1000000000000000000000000000000000000001
1000111110000000000000011111111111000001
1000000020000123000000000000000000000001
1000000020000010000000000000000000000001
1000000000000000000000000000000000000001
1000000000000000000000000000000000000001
1000333333333000002222222222222222222001
1000100000000000000000000002000000001001
1000200000000000009000000000000000001001
1000300000230000000000000002000000001001
1000000000320000000000000002000000001001
1100200000000000000000000000000000001001
1000200000000000000000000003000000001001
1000111111111111000111111111111111111001
1000200000000003000200000000000000000001
1000200000000003000000000000000000000001
1000200000000000000000000000000000000001
1000233333333322000220000000000000000001
1000000000000000000000000000000000000001
1000000000000000000000000000000000000001
1000000000000003333333000000000000000001
1000000000000000000000000000000000000001
1111111111122211111111111111111111111111